0000010000
1111000000
0000000111
0100000000
0000100001
0000100000
1100100110
0000000000
0010000100
0010000000
