0000100001
0010100100
0010100000
0000000001
0010111001
0010000000
0010001000
0010000010
0000011000
0000000000
