0100000000
0000000000
1111011000
0000000010
0101110000
0100000000
0100001001
0000000000
0001011000
0001000000
